[
  "---tct---",
  "#-iiiii-#",
  "##-----##",
  "a#-----#A",
  "##-----##",
  "#-IIIII-#",
  "---TCT---"
]