{
  "terrain": [
    "_______",
    "#___^__",
    "_____^_",
    "_^_^_^_",
    "_^_____",
    "__^___#",
    "_______"
  ],
  "units": [
    "aaiiiis",
    " i tc i",
    "       ",
    "       ",
    "       ",
    "I CT I ",
    "SIIIIAA"
  ]
}